file,metric,# groundtruth annotations (excl. dunder methods),# added PyHintSearch annotations (excl. dunder methods),# correct,# incorrect,precision,recall
.\_typing.py,adjusted_acc,17,17,4,13,0.24,0.24
.\_typing.py,base_acc,17,17,4,13,0.24,0.24
.\_version.py,adjusted_acc,1,1,0,1,0.0,0.0
.\_version.py,base_acc,1,1,0,1,0.0,0.0
arrays\__init__.py,adjusted_acc,1,1,1,0,1.0,1.0
arrays\__init__.py,base_acc,1,1,1,0,1.0,1.0
compat\compressors.py,adjusted_acc,4,1,1,3,1.0,0.25
compat\compressors.py,base_acc,4,1,1,3,1.0,0.25
compat\pickle_compat.py,adjusted_acc,4,4,3,1,0.75,0.75
compat\pickle_compat.py,base_acc,4,4,4,0,1.0,1.0
compat\_optional.py,adjusted_acc,6,6,3,3,0.5,0.5
compat\_optional.py,base_acc,6,6,3,3,0.5,0.5
compat\__init__.py,adjusted_acc,13,13,9,4,0.69,0.69
compat\__init__.py,base_acc,13,13,9,4,0.69,0.69
compat\numpy\function.py,adjusted_acc,20,15,5,15,0.33,0.25
compat\numpy\function.py,base_acc,20,15,6,14,0.4,0.3
core\accessor.py,adjusted_acc,20,18,10,10,0.56,0.5
core\accessor.py,base_acc,20,18,10,10,0.56,0.5
core\algorithms.py,adjusted_acc,88,8,0,88,0.0,0.0
core\algorithms.py,base_acc,88,8,3,85,0.38,0.03
core\arraylike.py,adjusted_acc,11,9,3,8,0.33,0.27
core\arraylike.py,base_acc,11,9,3,8,0.33,0.27
core\base.py,adjusted_acc,50,50,27,23,0.54,0.54
core\base.py,base_acc,50,50,28,22,0.56,0.56
core\common.py,adjusted_acc,33,33,10,23,0.3,0.3
core\common.py,base_acc,33,33,13,20,0.39,0.39
core\config_init.py,adjusted_acc,1,1,1,0,1.0,1.0
core\config_init.py,base_acc,1,1,1,0,1.0,1.0
core\construction.py,adjusted_acc,31,31,7,24,0.23,0.23
core\construction.py,base_acc,31,31,7,24,0.23,0.23
core\flags.py,adjusted_acc,5,4,3,2,0.75,0.6
core\flags.py,base_acc,5,4,3,2,0.75,0.6
core\sample.py,adjusted_acc,13,12,2,11,0.17,0.15
core\sample.py,base_acc,13,12,2,11,0.17,0.15
core\sorting.py,adjusted_acc,66,8,1,65,0.12,0.02
core\sorting.py,base_acc,66,8,6,60,0.75,0.09
core\arrays\boolean.py,adjusted_acc,21,21,6,15,0.29,0.29
core\arrays\boolean.py,base_acc,21,21,6,15,0.29,0.29
core\arrays\floating.py,adjusted_acc,6,6,2,4,0.33,0.33
core\arrays\floating.py,base_acc,6,6,2,4,0.33,0.33
core\arrays\integer.py,adjusted_acc,6,5,2,4,0.4,0.33
core\arrays\integer.py,base_acc,6,5,2,4,0.4,0.33
core\arrays\numeric.py,adjusted_acc,20,20,7,13,0.35,0.35
core\arrays\numeric.py,base_acc,20,20,7,13,0.35,0.35
core\arrays\numpy_.py,adjusted_acc,23,23,5,18,0.22,0.22
core\arrays\numpy_.py,base_acc,23,23,5,18,0.22,0.22
core\arrays\period.py,adjusted_acc,58,10,6,52,0.6,0.1
core\arrays\period.py,base_acc,58,10,7,51,0.7,0.12
core\arrays\string_.py,adjusted_acc,31,29,9,22,0.31,0.29
core\arrays\string_.py,base_acc,31,29,9,22,0.31,0.29
core\arrays\timedeltas.py,adjusted_acc,33,1,0,33,0.0,0.0
core\arrays\timedeltas.py,base_acc,33,1,1,32,1.0,0.03
core\arrays\_arrow_string_mixins.py,adjusted_acc,14,6,5,9,0.83,0.36
core\arrays\_arrow_string_mixins.py,base_acc,14,6,5,9,0.83,0.36
core\arrays\_mixins.py,adjusted_acc,46,45,11,35,0.24,0.24
core\arrays\_mixins.py,base_acc,46,45,11,35,0.24,0.24
core\arrays\_utils.py,adjusted_acc,4,4,0,4,0.0,0.0
core\arrays\_utils.py,base_acc,4,4,1,3,0.25,0.25
core\arrays\arrow\accessors.py,adjusted_acc,11,11,2,9,0.18,0.18
core\arrays\arrow\accessors.py,base_acc,11,11,2,9,0.18,0.18
core\arrays\arrow\extension_types.py,adjusted_acc,4,4,3,1,0.75,0.75
core\arrays\arrow\extension_types.py,base_acc,4,4,3,1,0.75,0.75
core\arrays\arrow\_arrow_utils.py,adjusted_acc,3,3,1,2,0.33,0.33
core\arrays\arrow\_arrow_utils.py,base_acc,3,3,2,1,0.67,0.67
core\arrays\sparse\accessor.py,adjusted_acc,11,11,2,9,0.18,0.18
core\arrays\sparse\accessor.py,base_acc,11,11,3,8,0.27,0.27
core\arrays\sparse\scipy_sparse.py,adjusted_acc,18,15,2,16,0.13,0.11
core\arrays\sparse\scipy_sparse.py,base_acc,18,15,3,15,0.2,0.17
core\array_algos\masked_accumulations.py,adjusted_acc,11,11,1,10,0.09,0.09
core\array_algos\masked_accumulations.py,base_acc,11,11,1,10,0.09,0.09
core\array_algos\putmask.py,adjusted_acc,11,11,4,7,0.36,0.36
core\array_algos\putmask.py,base_acc,11,11,5,6,0.45,0.45
core\array_algos\replace.py,adjusted_acc,10,9,0,10,0.0,0.0
core\array_algos\replace.py,base_acc,10,9,0,10,0.0,0.0
core\computation\align.py,adjusted_acc,6,5,1,5,0.2,0.17
core\computation\align.py,base_acc,6,5,2,4,0.4,0.33
core\computation\engines.py,adjusted_acc,4,4,2,2,0.5,0.5
core\computation\engines.py,base_acc,4,4,2,2,0.5,0.5
core\computation\expressions.py,adjusted_acc,8,1,1,7,1.0,0.12
core\computation\expressions.py,base_acc,8,1,1,7,1.0,0.12
core\computation\ops.py,adjusted_acc,18,17,11,7,0.65,0.61
core\computation\ops.py,base_acc,18,17,11,7,0.65,0.61
core\computation\parsing.py,adjusted_acc,12,12,4,8,0.33,0.33
core\computation\parsing.py,base_acc,12,12,5,7,0.42,0.42
core\computation\pytables.py,adjusted_acc,23,20,13,10,0.65,0.57
core\computation\pytables.py,base_acc,23,20,13,10,0.65,0.57
core\computation\scope.py,adjusted_acc,19,19,12,7,0.63,0.63
core\computation\scope.py,base_acc,19,19,12,7,0.63,0.63
core\dtypes\astype.py,adjusted_acc,20,20,6,14,0.3,0.3
core\dtypes\astype.py,base_acc,20,20,6,14,0.3,0.3
core\dtypes\base.py,adjusted_acc,31,27,9,22,0.33,0.29
core\dtypes\base.py,base_acc,31,27,9,22,0.33,0.29
core\dtypes\cast.py,adjusted_acc,88,16,3,85,0.19,0.03
core\dtypes\cast.py,base_acc,88,16,7,81,0.44,0.08
core\dtypes\common.py,adjusted_acc,64,62,22,42,0.35,0.34
core\dtypes\common.py,base_acc,64,62,24,40,0.39,0.38
core\dtypes\concat.py,adjusted_acc,12,10,3,9,0.3,0.25
core\dtypes\concat.py,base_acc,12,10,3,9,0.3,0.25
core\dtypes\inference.py,adjusted_acc,24,22,9,15,0.41,0.38
core\dtypes\inference.py,base_acc,24,22,9,15,0.41,0.38
core\dtypes\missing.py,adjusted_acc,41,40,16,25,0.4,0.39
core\dtypes\missing.py,base_acc,41,40,18,23,0.45,0.44
core\groupby\categorical.py,adjusted_acc,4,4,1,3,0.25,0.25
core\groupby\categorical.py,base_acc,4,4,1,3,0.25,0.25
core\groupby\grouper.py,adjusted_acc,38,31,14,24,0.45,0.37
core\groupby\grouper.py,base_acc,38,31,14,24,0.45,0.37
core\groupby\indexing.py,adjusted_acc,19,16,2,17,0.12,0.11
core\groupby\indexing.py,base_acc,19,16,2,17,0.12,0.11
core\groupby\numba_.py,adjusted_acc,11,11,7,4,0.64,0.64
core\groupby\numba_.py,base_acc,11,11,9,2,0.82,0.82
core\groupby\ops.py,adjusted_acc,95,94,27,68,0.29,0.28
core\groupby\ops.py,base_acc,95,94,33,62,0.35,0.35
core\indexers\objects.py,adjusted_acc,59,59,27,32,0.46,0.46
core\indexers\objects.py,base_acc,59,59,34,25,0.58,0.58
core\indexers\utils.py,adjusted_acc,17,16,8,9,0.5,0.47
core\indexers\utils.py,base_acc,17,16,8,9,0.5,0.47
core\indexes\accessors.py,adjusted_acc,13,12,9,4,0.75,0.69
core\indexes\accessors.py,base_acc,13,12,9,4,0.75,0.69
core\indexes\api.py,adjusted_acc,19,15,8,11,0.53,0.42
core\indexes\api.py,base_acc,19,15,9,10,0.6,0.47
core\indexes\category.py,adjusted_acc,21,20,4,17,0.2,0.19
core\indexes\category.py,base_acc,21,20,5,16,0.25,0.24
core\indexes\datetimelike.py,adjusted_acc,58,53,25,33,0.47,0.43
core\indexes\datetimelike.py,base_acc,58,53,26,32,0.49,0.45
core\indexes\datetimes.py,adjusted_acc,54,53,18,36,0.34,0.33
core\indexes\datetimes.py,base_acc,54,53,18,36,0.34,0.33
core\indexes\extension.py,adjusted_acc,13,13,5,8,0.38,0.38
core\indexes\extension.py,base_acc,13,13,6,7,0.46,0.46
core\indexes\frozen.py,adjusted_acc,4,3,0,4,0.0,0.0
core\indexes\frozen.py,base_acc,4,3,0,4,0.0,0.0
core\indexes\interval.py,adjusted_acc,71,65,22,49,0.34,0.31
core\indexes\interval.py,base_acc,71,65,24,47,0.37,0.34
core\indexes\period.py,adjusted_acc,37,33,13,24,0.39,0.35
core\indexes\period.py,base_acc,37,33,13,24,0.39,0.35
core\indexes\range.py,adjusted_acc,84,24,16,68,0.67,0.19
core\indexes\range.py,base_acc,84,24,18,66,0.75,0.21
core\indexes\timedeltas.py,adjusted_acc,21,17,4,17,0.24,0.19
core\indexes\timedeltas.py,base_acc,21,17,4,17,0.24,0.19
core\interchange\buffer.py,adjusted_acc,4,4,2,2,0.5,0.5
core\interchange\buffer.py,base_acc,4,4,2,2,0.5,0.5
core\interchange\column.py,adjusted_acc,14,10,4,10,0.4,0.29
core\interchange\column.py,base_acc,14,10,5,9,0.5,0.36
core\interchange\dataframe.py,adjusted_acc,20,19,13,7,0.68,0.65
core\interchange\dataframe.py,base_acc,20,19,14,6,0.74,0.7
core\interchange\dataframe_protocol.py,adjusted_acc,31,31,6,25,0.19,0.19
core\interchange\dataframe_protocol.py,base_acc,31,31,6,25,0.19,0.19
core\interchange\from_dataframe.py,adjusted_acc,23,22,3,20,0.14,0.13
core\interchange\from_dataframe.py,base_acc,23,22,7,16,0.32,0.3
core\interchange\utils.py,adjusted_acc,2,2,0,2,0.0,0.0
core\interchange\utils.py,base_acc,2,2,0,2,0.0,0.0
core\internals\api.py,adjusted_acc,6,5,2,4,0.4,0.33
core\internals\api.py,base_acc,6,5,2,4,0.4,0.33
core\internals\concat.py,adjusted_acc,36,33,12,24,0.36,0.33
core\internals\concat.py,base_acc,36,33,13,23,0.39,0.36
core\internals\construction.py,adjusted_acc,62,8,0,62,0.0,0.0
core\internals\construction.py,base_acc,62,8,3,59,0.38,0.05
core\internals\ops.py,adjusted_acc,15,15,11,4,0.73,0.73
core\internals\ops.py,base_acc,15,15,11,4,0.73,0.73
core\internals\__init__.py,adjusted_acc,1,1,1,0,1.0,1.0
core\internals\__init__.py,base_acc,1,1,1,0,1.0,1.0
core\methods\describe.py,adjusted_acc,28,28,2,26,0.07,0.07
core\methods\describe.py,base_acc,28,28,3,25,0.11,0.11
core\methods\selectn.py,adjusted_acc,17,1,1,16,1.0,0.06
core\methods\selectn.py,base_acc,17,1,1,16,1.0,0.06
core\methods\to_dict.py,adjusted_acc,7,7,3,4,0.43,0.43
core\methods\to_dict.py,base_acc,7,7,4,3,0.57,0.57
core\ops\array_ops.py,adjusted_acc,11,11,1,10,0.09,0.09
core\ops\array_ops.py,base_acc,11,11,1,10,0.09,0.09
core\ops\common.py,adjusted_acc,5,4,2,3,0.5,0.4
core\ops\common.py,base_acc,5,4,3,2,0.75,0.6
core\ops\dispatch.py,adjusted_acc,2,2,1,1,0.5,0.5
core\ops\dispatch.py,base_acc,2,2,1,1,0.5,0.5
core\ops\docstrings.py,adjusted_acc,3,3,3,0,1.0,1.0
core\ops\docstrings.py,base_acc,3,3,3,0,1.0,1.0
core\ops\invalid.py,adjusted_acc,3,3,2,1,0.67,0.67
core\ops\invalid.py,base_acc,3,3,2,1,0.67,0.67
core\ops\mask_ops.py,adjusted_acc,13,13,6,7,0.46,0.46
core\ops\mask_ops.py,base_acc,13,13,9,4,0.69,0.69
core\ops\missing.py,adjusted_acc,4,0,0,4,-,0.0
core\ops\missing.py,base_acc,4,0,0,4,-,0.0
core\reshape\concat.py,adjusted_acc,31,1,0,31,0.0,0.0
core\reshape\concat.py,base_acc,31,1,1,30,1.0,0.03
core\reshape\encoding.py,adjusted_acc,19,19,6,13,0.32,0.32
core\reshape\encoding.py,base_acc,19,19,6,13,0.32,0.32
core\reshape\melt.py,adjusted_acc,21,21,8,13,0.38,0.38
core\reshape\melt.py,base_acc,21,21,8,13,0.38,0.38
core\reshape\reshape.py,adjusted_acc,45,42,12,33,0.29,0.27
core\reshape\reshape.py,base_acc,45,42,14,31,0.33,0.31
core\reshape\tile.py,adjusted_acc,42,42,15,27,0.36,0.36
core\reshape\tile.py,base_acc,42,42,16,26,0.38,0.38
core\reshape\util.py,adjusted_acc,4,4,1,3,0.25,0.25
core\reshape\util.py,base_acc,4,4,2,2,0.5,0.5
core\tools\datetimes.py,adjusted_acc,49,46,11,38,0.24,0.22
core\tools\datetimes.py,base_acc,49,46,12,37,0.26,0.24
core\tools\timedeltas.py,adjusted_acc,10,9,0,10,0.0,0.0
core\tools\timedeltas.py,base_acc,10,9,1,9,0.11,0.1
core\tools\times.py,adjusted_acc,3,3,2,1,0.67,0.67
core\tools\times.py,base_acc,3,3,2,1,0.67,0.67
core\util\numba_.py,adjusted_acc,8,6,4,4,0.67,0.5
core\util\numba_.py,base_acc,8,6,5,3,0.83,0.62
core\window\common.py,adjusted_acc,1,1,0,1,0.0,0.0
core\window\common.py,base_acc,1,1,0,1,0.0,0.0
core\window\doc.py,adjusted_acc,4,4,3,1,0.75,0.75
core\window\doc.py,base_acc,4,4,3,1,0.75,0.75
core\window\ewm.py,adjusted_acc,65,2,2,63,1.0,0.03
core\window\ewm.py,base_acc,65,2,2,63,1.0,0.03
core\window\expanding.py,adjusted_acc,70,67,16,54,0.24,0.23
core\window\expanding.py,base_acc,70,67,17,53,0.25,0.24
core\window\numba_.py,adjusted_acc,24,24,18,6,0.75,0.75
core\window\numba_.py,base_acc,24,24,18,6,0.75,0.75
core\window\online.py,adjusted_acc,3,3,0,3,0.0,0.0
core\window\online.py,base_acc,3,3,0,3,0.0,0.0
core\_numba\executor.py,adjusted_acc,6,6,4,2,0.67,0.67
core\_numba\executor.py,base_acc,6,6,4,2,0.67,0.67
core\_numba\extensions.py,adjusted_acc,5,5,0,5,0.0,0.0
core\_numba\extensions.py,base_acc,5,5,0,5,0.0,0.0
core\_numba\kernels\mean_.py,adjusted_acc,26,24,7,19,0.29,0.27
core\_numba\kernels\mean_.py,base_acc,26,24,11,15,0.46,0.42
core\_numba\kernels\min_max_.py,adjusted_acc,14,14,6,8,0.43,0.43
core\_numba\kernels\min_max_.py,base_acc,14,14,8,6,0.57,0.57
core\_numba\kernels\shared.py,adjusted_acc,2,2,1,1,0.5,0.5
core\_numba\kernels\shared.py,base_acc,2,2,1,1,0.5,0.5
core\_numba\kernels\sum_.py,adjusted_acc,22,22,6,16,0.27,0.27
core\_numba\kernels\sum_.py,base_acc,22,22,11,11,0.5,0.5
core\_numba\kernels\var_.py,adjusted_acc,28,27,11,17,0.41,0.39
core\_numba\kernels\var_.py,base_acc,28,27,15,13,0.56,0.54
errors\__init__.py,adjusted_acc,4,4,2,2,0.5,0.5
errors\__init__.py,base_acc,4,4,2,2,0.5,0.5
io\clipboards.py,adjusted_acc,5,5,2,3,0.4,0.4
io\clipboards.py,base_acc,5,5,2,3,0.4,0.4
io\common.py,adjusted_acc,66,62,26,40,0.42,0.39
io\common.py,base_acc,66,62,27,39,0.44,0.41
io\feather_format.py,adjusted_acc,9,8,2,7,0.25,0.22
io\feather_format.py,base_acc,9,8,2,7,0.25,0.22
io\gbq.py,adjusted_acc,26,26,11,15,0.42,0.42
io\gbq.py,base_acc,26,26,11,15,0.42,0.42
io\orc.py,adjusted_acc,8,7,1,7,0.14,0.12
io\orc.py,base_acc,8,7,1,7,0.14,0.12
io\parquet.py,adjusted_acc,41,4,1,40,0.25,0.02
io\parquet.py,base_acc,41,4,1,40,0.25,0.02
io\pickle.py,adjusted_acc,8,8,1,7,0.12,0.12
io\pickle.py,base_acc,8,8,1,7,0.12,0.12
io\spss.py,adjusted_acc,5,5,1,4,0.2,0.2
io\spss.py,base_acc,5,5,1,4,0.2,0.2
io\xml.py,adjusted_acc,57,54,10,47,0.19,0.18
io\xml.py,base_acc,57,54,11,46,0.2,0.19
io\_util.py,adjusted_acc,2,1,0,2,0.0,0.0
io\_util.py,base_acc,2,1,1,1,1.0,0.5
io\clipboard\__init__.py,adjusted_acc,2,2,2,0,1.0,1.0
io\clipboard\__init__.py,base_acc,2,2,2,0,1.0,1.0
io\excel\_calamine.py,adjusted_acc,14,14,2,12,0.14,0.14
io\excel\_calamine.py,base_acc,14,14,4,10,0.29,0.29
io\excel\_odfreader.py,adjusted_acc,16,15,7,9,0.47,0.44
io\excel\_odfreader.py,base_acc,16,15,8,8,0.53,0.5
io\excel\_odswriter.py,adjusted_acc,19,17,8,11,0.47,0.42
io\excel\_odswriter.py,base_acc,19,17,9,10,0.53,0.47
io\excel\_openpyxl.py,adjusted_acc,30,27,9,21,0.33,0.3
io\excel\_openpyxl.py,base_acc,30,27,11,19,0.41,0.37
io\excel\_pyxlsb.py,adjusted_acc,12,12,4,8,0.33,0.33
io\excel\_pyxlsb.py,base_acc,12,12,4,8,0.33,0.33
io\excel\_util.py,adjusted_acc,23,19,7,16,0.37,0.3
io\excel\_util.py,base_acc,23,19,9,14,0.47,0.39
io\excel\_xlrd.py,adjusted_acc,6,6,0,6,0.0,0.0
io\excel\_xlrd.py,base_acc,6,6,1,5,0.17,0.17
io\excel\_xlsxwriter.py,adjusted_acc,13,12,7,6,0.58,0.54
io\excel\_xlsxwriter.py,base_acc,13,12,7,6,0.58,0.54
io\formats\console.py,adjusted_acc,3,3,1,2,0.33,0.33
io\formats\console.py,base_acc,3,3,2,1,0.67,0.67
io\formats\css.py,adjusted_acc,23,16,5,18,0.31,0.22
io\formats\css.py,base_acc,23,16,9,14,0.56,0.39
io\formats\csvs.py,adjusted_acc,44,41,20,24,0.49,0.45
io\formats\csvs.py,base_acc,44,41,20,24,0.49,0.45
io\formats\excel.py,adjusted_acc,92,8,1,91,0.12,0.01
io\formats\excel.py,base_acc,92,8,7,85,0.88,0.08
io\formats\html.py,adjusted_acc,43,5,4,39,0.8,0.09
io\formats\html.py,base_acc,43,5,4,39,0.8,0.09
io\formats\info.py,adjusted_acc,81,69,22,59,0.32,0.27
io\formats\info.py,base_acc,81,69,23,58,0.33,0.28
io\formats\printing.py,adjusted_acc,49,47,26,23,0.55,0.53
io\formats\printing.py,base_acc,49,47,29,20,0.62,0.59
io\formats\string.py,adjusted_acc,23,19,8,15,0.42,0.35
io\formats\string.py,base_acc,23,19,10,13,0.53,0.43
io\formats\xml.py,adjusted_acc,31,1,0,31,0.0,0.0
io\formats\xml.py,base_acc,31,1,0,31,0.0,0.0
io\json\_json.py,adjusted_acc,75,8,2,73,0.25,0.03
io\json\_json.py,base_acc,75,8,4,71,0.5,0.05
io\json\_normalize.py,adjusted_acc,27,26,12,15,0.46,0.44
io\json\_normalize.py,base_acc,27,26,14,13,0.54,0.52
io\json\_table_schema.py,adjusted_acc,11,11,2,9,0.18,0.18
io\json\_table_schema.py,base_acc,11,11,3,8,0.27,0.27
io\parsers\arrow_parser_wrapper.py,adjusted_acc,4,4,0,4,0.0,0.0
io\parsers\arrow_parser_wrapper.py,base_acc,4,4,0,4,0.0,0.0
io\parsers\base_parser.py,adjusted_acc,51,1,1,50,1.0,0.02
io\parsers\base_parser.py,base_acc,51,1,1,50,1.0,0.02
io\parsers\c_parser_wrapper.py,adjusted_acc,11,9,0,11,0.0,0.0
io\parsers\c_parser_wrapper.py,base_acc,11,9,3,8,0.33,0.27
io\parsers\python_parser.py,adjusted_acc,68,6,1,67,0.17,0.01
io\parsers\python_parser.py,base_acc,68,6,4,64,0.67,0.06
io\parsers\readers.py,adjusted_acc,52,7,7,45,1.0,0.13
io\parsers\readers.py,base_acc,52,7,7,45,1.0,0.13
io\sas\sas7bdat.py,adjusted_acc,56,56,32,24,0.57,0.57
io\sas\sas7bdat.py,base_acc,56,56,32,24,0.57,0.57
io\sas\sasreader.py,adjusted_acc,7,7,2,5,0.29,0.29
io\sas\sasreader.py,base_acc,7,7,2,5,0.29,0.29
io\sas\sas_xport.py,adjusted_acc,12,12,8,4,0.67,0.67
io\sas\sas_xport.py,base_acc,12,12,8,4,0.67,0.67
plotting\_misc.py,adjusted_acc,53,9,0,53,0.0,0.0
plotting\_misc.py,base_acc,53,9,1,52,0.11,0.02
plotting\_matplotlib\boxplot.py,adjusted_acc,30,29,8,22,0.28,0.27
plotting\_matplotlib\boxplot.py,base_acc,30,29,8,22,0.28,0.27
plotting\_matplotlib\groupby.py,adjusted_acc,10,10,3,7,0.3,0.3
plotting\_matplotlib\groupby.py,base_acc,10,10,4,6,0.4,0.4
plotting\_matplotlib\misc.py,adjusted_acc,32,31,8,24,0.26,0.25
plotting\_matplotlib\misc.py,base_acc,32,31,8,24,0.26,0.25
plotting\_matplotlib\style.py,adjusted_acc,32,29,9,23,0.31,0.28
plotting\_matplotlib\style.py,base_acc,32,29,14,18,0.48,0.44
plotting\_matplotlib\timeseries.py,adjusted_acc,32,29,3,29,0.1,0.09
plotting\_matplotlib\timeseries.py,base_acc,32,29,3,29,0.1,0.09
plotting\_matplotlib\tools.py,adjusted_acc,35,34,5,30,0.15,0.14
plotting\_matplotlib\tools.py,base_acc,35,34,6,29,0.18,0.17
tseries\frequencies.py,adjusted_acc,42,11,8,34,0.73,0.19
tseries\frequencies.py,base_acc,42,11,10,32,0.91,0.24
tseries\holiday.py,adjusted_acc,61,59,26,35,0.44,0.43
tseries\holiday.py,base_acc,61,59,29,32,0.49,0.48
util\_decorators.py,adjusted_acc,30,30,17,13,0.57,0.57
util\_decorators.py,base_acc,30,30,20,10,0.67,0.67
util\_doctools.py,adjusted_acc,11,9,1,10,0.11,0.09
util\_doctools.py,base_acc,11,9,1,10,0.11,0.09
util\_exceptions.py,adjusted_acc,9,9,5,4,0.56,0.56
util\_exceptions.py,base_acc,9,9,7,2,0.78,0.78
util\_print_versions.py,adjusted_acc,4,3,2,2,0.67,0.5
util\_print_versions.py,base_acc,4,3,2,2,0.67,0.5
util\_test_decorators.py,adjusted_acc,6,5,2,4,0.4,0.33
util\_test_decorators.py,base_acc,6,5,3,3,0.6,0.5
util\_validators.py,adjusted_acc,17,16,7,10,0.44,0.41
util\_validators.py,base_acc,17,16,8,9,0.5,0.47
util\__init__.py,adjusted_acc,1,1,1,0,1.0,1.0
util\__init__.py,base_acc,1,1,1,0,1.0,1.0
util\version\__init__.py,adjusted_acc,58,45,21,37,0.47,0.36
util\version\__init__.py,base_acc,58,45,22,36,0.49,0.38
_config\config.py,adjusted_acc,53,6,1,52,0.17,0.02
_config\config.py,base_acc,53,6,5,48,0.83,0.09
_config\display.py,adjusted_acc,1,1,1,0,1.0,1.0
_config\display.py,base_acc,1,1,1,0,1.0,1.0
_config\localization.py,adjusted_acc,12,9,5,7,0.56,0.42
_config\localization.py,base_acc,12,9,6,6,0.67,0.5
_config\__init__.py,adjusted_acc,4,4,0,4,0.0,0.0
_config\__init__.py,base_acc,4,4,0,4,0.0,0.0
_testing\contexts.py,adjusted_acc,10,10,3,7,0.3,0.3
_testing\contexts.py,base_acc,10,10,8,2,0.8,0.8
_testing\_io.py,adjusted_acc,4,3,0,4,0.0,0.0
_testing\_io.py,base_acc,4,3,0,4,0.0,0.0
_testing\_warnings.py,adjusted_acc,13,12,4,9,0.33,0.31
_testing\_warnings.py,base_acc,13,12,5,8,0.42,0.38
_testing\__init__.py,adjusted_acc,11,10,4,7,0.4,0.36
_testing\__init__.py,base_acc,11,10,4,7,0.4,0.36
