file,metric,# groundtruth annotations (excl. dunder methods),# added PyHintSearch annotations (excl. dunder methods),# correct,# incorrect,precision,recall
.\shortcuts.py,adjusted_acc,19,5,3,16,0.6,0.16
.\shortcuts.py,base_acc,19,5,5,14,1.0,0.26
.\__init__.py,adjusted_acc,1,0,0,1,-,0.0
.\__init__.py,base_acc,1,0,0,1,-,0.0
apps\config.py,adjusted_acc,10,2,0,10,0.0,0.0
apps\config.py,base_acc,10,2,0,10,0.0,0.0
apps\registry.py,adjusted_acc,27,5,1,26,0.2,0.04
apps\registry.py,base_acc,27,5,2,25,0.4,0.07
conf\__init__.py,adjusted_acc,12,3,2,10,0.67,0.17
conf\__init__.py,base_acc,12,3,2,10,0.67,0.17
conf\urls\i18n.py,adjusted_acc,3,2,0,3,0.0,0.0
conf\urls\i18n.py,base_acc,3,2,0,3,0.0,0.0
conf\urls\static.py,adjusted_acc,3,1,0,3,0.0,0.0
conf\urls\static.py,base_acc,3,1,0,3,0.0,0.0
contrib\admin\actions.py,adjusted_acc,4,1,1,3,1.0,0.25
contrib\admin\actions.py,base_acc,4,1,1,3,1.0,0.25
contrib\admin\decorators.py,adjusted_acc,3,3,0,3,0.0,0.0
contrib\admin\decorators.py,base_acc,3,3,3,0,1.0,1.0
contrib\admin\helpers.py,adjusted_acc,53,10,3,50,0.3,0.06
contrib\admin\helpers.py,base_acc,53,10,3,50,0.3,0.06
contrib\admin\sites.py,adjusted_acc,56,13,6,50,0.46,0.11
contrib\admin\sites.py,base_acc,56,13,8,48,0.62,0.14
contrib\admin\utils.py,adjusted_acc,64,19,3,61,0.16,0.05
contrib\admin\utils.py,base_acc,64,19,11,53,0.58,0.17
contrib\admin\widgets.py,adjusted_acc,71,11,4,67,0.36,0.06
contrib\admin\widgets.py,base_acc,71,11,10,61,0.91,0.14
contrib\admin\__init__.py,adjusted_acc,0,0,0,0,-,-
contrib\admin\__init__.py,base_acc,0,0,0,0,-,-
contrib\admin\templatetags\admin_list.py,adjusted_acc,45,15,8,37,0.53,0.18
contrib\admin\templatetags\admin_list.py,base_acc,45,15,10,35,0.67,0.22
contrib\admin\templatetags\admin_modify.py,adjusted_acc,15,5,5,10,1.0,0.33
contrib\admin\templatetags\admin_modify.py,base_acc,15,5,5,10,1.0,0.33
contrib\admin\templatetags\admin_urls.py,adjusted_acc,10,3,0,10,0.0,0.0
contrib\admin\templatetags\admin_urls.py,base_acc,10,3,0,10,0.0,0.0
contrib\admin\templatetags\base.py,adjusted_acc,7,1,1,6,1.0,0.14
contrib\admin\templatetags\base.py,base_acc,7,1,1,6,1.0,0.14
contrib\admin\templatetags\log.py,adjusted_acc,8,2,1,7,0.5,0.12
contrib\admin\templatetags\log.py,base_acc,8,2,1,7,0.5,0.12
contrib\admin\views\autocomplete.py,adjusted_acc,3,0,0,3,-,0.0
contrib\admin\views\autocomplete.py,base_acc,3,0,0,3,-,0.0
contrib\admin\views\decorators.py,adjusted_acc,3,1,0,3,0.0,0.0
contrib\admin\views\decorators.py,base_acc,3,1,0,3,0.0,0.0
contrib\admin\views\main.py,adjusted_acc,35,6,3,32,0.5,0.09
contrib\admin\views\main.py,base_acc,35,6,5,30,0.83,0.14
contrib\admindocs\middleware.py,adjusted_acc,5,1,1,4,1.0,0.2
contrib\admindocs\middleware.py,base_acc,5,1,1,4,1.0,0.2
contrib\admindocs\utils.py,adjusted_acc,16,4,1,15,0.25,0.06
contrib\admindocs\utils.py,base_acc,16,4,2,14,0.5,0.12
contrib\admindocs\views.py,adjusted_acc,9,3,1,8,0.33,0.11
contrib\admindocs\views.py,base_acc,9,3,2,7,0.67,0.22
contrib\auth\admin.py,adjusted_acc,4,1,0,4,0.0,0.0
contrib\auth\admin.py,base_acc,4,1,0,4,0.0,0.0
contrib\auth\backends.py,adjusted_acc,36,9,2,34,0.22,0.06
contrib\auth\backends.py,base_acc,36,9,5,31,0.56,0.14
contrib\auth\base_user.py,adjusted_acc,16,11,4,12,0.36,0.25
contrib\auth\base_user.py,base_acc,16,11,5,11,0.45,0.31
contrib\auth\checks.py,adjusted_acc,4,2,0,4,0.0,0.0
contrib\auth\checks.py,base_acc,4,2,0,4,0.0,0.0
contrib\auth\context_processors.py,adjusted_acc,5,1,1,4,1.0,0.2
contrib\auth\context_processors.py,base_acc,5,1,1,4,1.0,0.2
contrib\auth\decorators.py,adjusted_acc,12,3,0,12,0.0,0.0
contrib\auth\decorators.py,base_acc,12,3,2,10,0.67,0.17
contrib\auth\forms.py,adjusted_acc,41,8,1,40,0.12,0.02
contrib\auth\forms.py,base_acc,41,8,2,39,0.25,0.05
contrib\auth\hashers.py,adjusted_acc,49,14,3,46,0.21,0.06
contrib\auth\hashers.py,base_acc,49,14,8,41,0.57,0.16
contrib\auth\middleware.py,adjusted_acc,7,2,0,7,0.0,0.0
contrib\auth\middleware.py,base_acc,7,2,1,6,0.5,0.14
contrib\auth\mixins.py,adjusted_acc,14,9,3,11,0.33,0.21
contrib\auth\mixins.py,base_acc,14,9,4,10,0.44,0.29
contrib\auth\models.py,adjusted_acc,64,25,11,53,0.44,0.17
contrib\auth\models.py,base_acc,64,25,17,47,0.68,0.27
contrib\auth\tokens.py,adjusted_acc,15,2,2,13,1.0,0.13
contrib\auth\tokens.py,base_acc,15,2,2,13,1.0,0.13
contrib\auth\views.py,adjusted_acc,18,8,3,15,0.38,0.17
contrib\auth\views.py,base_acc,18,8,4,14,0.5,0.22
contrib\auth\__init__.py,adjusted_acc,27,5,0,27,0.0,0.0
contrib\auth\__init__.py,base_acc,27,5,2,25,0.4,0.07
contrib\auth\handlers\modwsgi.py,adjusted_acc,5,0,0,5,-,0.0
contrib\auth\handlers\modwsgi.py,base_acc,5,0,0,5,-,0.0
contrib\auth\management\__init__.py,adjusted_acc,9,2,2,7,1.0,0.22
contrib\auth\management\__init__.py,base_acc,9,2,2,7,1.0,0.22
contrib\contenttypes\admin.py,adjusted_acc,6,0,0,6,-,0.0
contrib\contenttypes\admin.py,base_acc,6,0,0,6,-,0.0
contrib\contenttypes\checks.py,adjusted_acc,4,2,0,4,0.0,0.0
contrib\contenttypes\checks.py,base_acc,4,2,0,4,0.0,0.0
contrib\contenttypes\fields.py,adjusted_acc,45,11,2,43,0.18,0.04
contrib\contenttypes\fields.py,base_acc,45,11,8,37,0.73,0.18
contrib\contenttypes\forms.py,adjusted_acc,18,2,1,17,0.5,0.06
contrib\contenttypes\forms.py,base_acc,18,2,1,17,0.5,0.06
contrib\contenttypes\models.py,adjusted_acc,14,7,0,14,0.0,0.0
contrib\contenttypes\models.py,base_acc,14,7,2,12,0.29,0.14
contrib\contenttypes\management\__init__.py,adjusted_acc,19,1,0,19,0.0,0.0
contrib\contenttypes\management\__init__.py,base_acc,19,1,0,19,0.0,0.0
contrib\contenttypes\management\commands\remove_stale_contenttypes.py,adjusted_acc,1,1,1,0,1.0,1.0
contrib\contenttypes\management\commands\remove_stale_contenttypes.py,base_acc,1,1,1,0,1.0,1.0
contrib\flatpages\middleware.py,adjusted_acc,3,1,0,3,0.0,0.0
contrib\flatpages\middleware.py,base_acc,3,1,0,3,0.0,0.0
contrib\flatpages\models.py,adjusted_acc,1,1,1,0,1.0,1.0
contrib\flatpages\models.py,base_acc,1,1,1,0,1.0,1.0
contrib\flatpages\views.py,adjusted_acc,6,2,0,6,0.0,0.0
contrib\flatpages\views.py,base_acc,6,2,0,6,0.0,0.0
contrib\flatpages\templatetags\flatpages.py,adjusted_acc,8,2,1,7,0.5,0.12
contrib\flatpages\templatetags\flatpages.py,base_acc,8,2,1,7,0.5,0.12
contrib\gis\feeds.py,adjusted_acc,10,3,0,10,0.0,0.0
contrib\gis\feeds.py,base_acc,10,3,2,8,0.67,0.2
contrib\gis\measure.py,adjusted_acc,16,1,0,16,0.0,0.0
contrib\gis\measure.py,base_acc,16,1,1,15,1.0,0.06
contrib\gis\ptr.py,adjusted_acc,0,0,0,0,-,-
contrib\gis\ptr.py,base_acc,0,0,0,0,-,-
contrib\gis\shortcuts.py,adjusted_acc,4,3,3,1,1.0,0.75
contrib\gis\shortcuts.py,base_acc,4,3,3,1,1.0,0.75
contrib\gis\db\backends\utils.py,adjusted_acc,5,1,0,5,0.0,0.0
contrib\gis\db\backends\utils.py,base_acc,5,1,0,5,0.0,0.0
contrib\gis\db\backends\base\adapter.py,adjusted_acc,1,0,0,1,-,0.0
contrib\gis\db\backends\base\adapter.py,base_acc,1,0,0,1,-,0.0
contrib\gis\db\backends\base\features.py,adjusted_acc,11,11,11,0,1.0,1.0
contrib\gis\db\backends\base\features.py,base_acc,11,11,11,0,1.0,1.0
contrib\gis\db\backends\base\models.py,adjusted_acc,1,0,0,1,-,0.0
contrib\gis\db\backends\base\models.py,base_acc,1,0,0,1,-,0.0
contrib\gis\db\backends\base\operations.py,adjusted_acc,1,1,1,0,1.0,1.0
contrib\gis\db\backends\base\operations.py,base_acc,1,1,1,0,1.0,1.0
contrib\gis\db\backends\mysql\introspection.py,adjusted_acc,0,0,0,0,-,-
contrib\gis\db\backends\mysql\introspection.py,base_acc,0,0,0,0,-,-
contrib\gis\db\backends\mysql\operations.py,adjusted_acc,8,7,6,2,0.86,0.75
contrib\gis\db\backends\mysql\operations.py,base_acc,8,7,7,1,1.0,0.88
contrib\gis\db\backends\mysql\schema.py,adjusted_acc,1,0,0,1,-,0.0
contrib\gis\db\backends\mysql\schema.py,base_acc,1,0,0,1,-,0.0
contrib\gis\db\backends\oracle\adapter.py,adjusted_acc,0,0,0,0,-,-
contrib\gis\db\backends\oracle\adapter.py,base_acc,0,0,0,0,-,-
contrib\gis\db\backends\oracle\introspection.py,adjusted_acc,0,0,0,0,-,-
contrib\gis\db\backends\oracle\introspection.py,base_acc,0,0,0,0,-,-
contrib\gis\db\backends\oracle\models.py,adjusted_acc,0,0,0,0,-,-
contrib\gis\db\backends\oracle\models.py,base_acc,0,0,0,0,-,-
contrib\gis\db\backends\oracle\operations.py,adjusted_acc,0,0,0,0,-,-
contrib\gis\db\backends\oracle\operations.py,base_acc,0,0,0,0,-,-
contrib\gis\db\backends\oracle\schema.py,adjusted_acc,1,0,0,1,-,0.0
contrib\gis\db\backends\oracle\schema.py,base_acc,1,0,0,1,-,0.0
contrib\gis\db\backends\postgis\adapter.py,adjusted_acc,2,0,0,2,-,0.0
contrib\gis\db\backends\postgis\adapter.py,base_acc,2,0,0,2,-,0.0
contrib\gis\db\backends\postgis\base.py,adjusted_acc,0,0,0,0,-,-
contrib\gis\db\backends\postgis\base.py,base_acc,0,0,0,0,-,-
contrib\gis\db\backends\postgis\introspection.py,adjusted_acc,0,0,0,0,-,-
contrib\gis\db\backends\postgis\introspection.py,base_acc,0,0,0,0,-,-
contrib\gis\db\backends\postgis\models.py,adjusted_acc,0,0,0,0,-,-
contrib\gis\db\backends\postgis\models.py,base_acc,0,0,0,0,-,-
contrib\gis\db\backends\postgis\operations.py,adjusted_acc,3,1,1,2,1.0,0.33
contrib\gis\db\backends\postgis\operations.py,base_acc,3,1,1,2,1.0,0.33
contrib\gis\db\backends\postgis\pgraster.py,adjusted_acc,0,0,0,0,-,-
contrib\gis\db\backends\postgis\pgraster.py,base_acc,0,0,0,0,-,-
contrib\gis\db\backends\spatialite\adapter.py,adjusted_acc,0,0,0,0,-,-
contrib\gis\db\backends\spatialite\adapter.py,base_acc,0,0,0,0,-,-
contrib\gis\db\backends\spatialite\base.py,adjusted_acc,0,0,0,0,-,-
contrib\gis\db\backends\spatialite\base.py,base_acc,0,0,0,0,-,-
contrib\gis\db\backends\spatialite\features.py,adjusted_acc,1,1,1,0,1.0,1.0
contrib\gis\db\backends\spatialite\features.py,base_acc,1,1,1,0,1.0,1.0
contrib\gis\db\backends\spatialite\introspection.py,adjusted_acc,0,0,0,0,-,-
contrib\gis\db\backends\spatialite\introspection.py,base_acc,0,0,0,0,-,-
contrib\gis\db\backends\spatialite\models.py,adjusted_acc,0,0,0,0,-,-
contrib\gis\db\backends\spatialite\models.py,base_acc,0,0,0,0,-,-
contrib\gis\db\backends\spatialite\operations.py,adjusted_acc,1,1,1,0,1.0,1.0
contrib\gis\db\backends\spatialite\operations.py,base_acc,1,1,1,0,1.0,1.0
contrib\gis\db\backends\spatialite\schema.py,adjusted_acc,1,0,0,1,-,0.0
contrib\gis\db\backends\spatialite\schema.py,base_acc,1,0,0,1,-,0.0
contrib\gis\db\models\aggregates.py,adjusted_acc,3,1,0,3,0.0,0.0
contrib\gis\db\models\aggregates.py,base_acc,3,1,0,3,0.0,0.0
contrib\gis\db\models\functions.py,adjusted_acc,59,4,3,56,0.75,0.05
contrib\gis\db\models\functions.py,base_acc,59,4,3,56,0.75,0.05
contrib\gis\db\models\lookups.py,adjusted_acc,1,0,0,1,-,0.0
contrib\gis\db\models\lookups.py,base_acc,1,0,0,1,-,0.0
contrib\gis\db\models\proxy.py,adjusted_acc,0,0,0,0,-,-
contrib\gis\db\models\proxy.py,base_acc,0,0,0,0,-,-
contrib\gis\db\models\sql\conversion.py,adjusted_acc,2,0,0,2,-,0.0
contrib\gis\db\models\sql\conversion.py,base_acc,2,0,0,2,-,0.0
contrib\gis\forms\fields.py,adjusted_acc,0,0,0,0,-,-
contrib\gis\forms\fields.py,base_acc,0,0,0,0,-,-
contrib\gis\forms\widgets.py,adjusted_acc,0,0,0,0,-,-
contrib\gis\forms\widgets.py,base_acc,0,0,0,0,-,-
contrib\gis\gdal\datasource.py,adjusted_acc,6,2,1,5,0.5,0.17
contrib\gis\gdal\datasource.py,base_acc,6,2,1,5,0.5,0.17
contrib\gis\gdal\driver.py,adjusted_acc,2,2,1,1,0.5,0.5
contrib\gis\gdal\driver.py,base_acc,2,2,1,1,0.5,0.5
contrib\gis\gdal\envelope.py,adjusted_acc,9,8,0,9,0.0,0.0
contrib\gis\gdal\envelope.py,base_acc,9,8,3,6,0.38,0.33
contrib\gis\gdal\error.py,adjusted_acc,1,0,0,1,-,0.0
contrib\gis\gdal\error.py,base_acc,1,0,0,1,-,0.0
contrib\gis\gdal\feature.py,adjusted_acc,11,6,3,8,0.5,0.27
contrib\gis\gdal\feature.py,base_acc,11,6,4,7,0.67,0.36
contrib\gis\gdal\field.py,adjusted_acc,11,10,2,9,0.2,0.18
contrib\gis\gdal\field.py,base_acc,11,10,3,8,0.3,0.27
contrib\gis\gdal\geometries.py,adjusted_acc,77,40,17,60,0.42,0.22
contrib\gis\gdal\geometries.py,base_acc,77,40,24,53,0.6,0.31
contrib\gis\gdal\geomtype.py,adjusted_acc,3,2,2,1,1.0,0.67
contrib\gis\gdal\geomtype.py,base_acc,3,2,2,1,1.0,0.67
contrib\gis\gdal\layer.py,adjusted_acc,17,13,5,12,0.38,0.29
contrib\gis\gdal\layer.py,base_acc,17,13,10,7,0.77,0.59
contrib\gis\gdal\libgdal.py,adjusted_acc,9,3,0,9,0.0,0.0
contrib\gis\gdal\libgdal.py,base_acc,9,3,1,8,0.33,0.11
contrib\gis\gdal\srs.py,adjusted_acc,36,14,4,32,0.29,0.11
contrib\gis\gdal\srs.py,base_acc,36,14,6,30,0.43,0.17
contrib\gis\gdal\prototypes\errcheck.py,adjusted_acc,9,0,0,9,-,0.0
contrib\gis\gdal\prototypes\errcheck.py,base_acc,9,0,0,9,-,0.0
contrib\gis\gdal\raster\band.py,adjusted_acc,17,11,6,11,0.55,0.35
contrib\gis\gdal\raster\band.py,base_acc,17,11,6,11,0.55,0.35
contrib\gis\gdal\raster\base.py,adjusted_acc,0,0,0,0,-,-
contrib\gis\gdal\raster\base.py,base_acc,0,0,0,0,-,-
contrib\gis\gdal\raster\source.py,adjusted_acc,31,14,10,21,0.71,0.32
contrib\gis\gdal\raster\source.py,base_acc,31,14,11,20,0.79,0.35
contrib\gis\geos\collections.py,adjusted_acc,1,1,1,0,1.0,1.0
contrib\gis\geos\collections.py,base_acc,1,1,1,0,1.0,1.0
contrib\gis\geos\coordseq.py,adjusted_acc,28,5,2,26,0.4,0.07
contrib\gis\geos\coordseq.py,base_acc,28,5,2,26,0.4,0.07
contrib\gis\geos\factory.py,adjusted_acc,4,2,2,2,1.0,0.5
contrib\gis\geos\factory.py,base_acc,4,2,2,2,1.0,0.5
contrib\gis\geos\io.py,adjusted_acc,4,2,2,2,1.0,0.5
contrib\gis\geos\io.py,base_acc,4,2,2,2,1.0,0.5
contrib\gis\geos\libgeos.py,adjusted_acc,2,2,0,2,0.0,0.0
contrib\gis\geos\libgeos.py,base_acc,2,2,1,1,0.5,0.5
contrib\gis\geos\linestring.py,adjusted_acc,2,2,1,1,0.5,0.5
contrib\gis\geos\linestring.py,base_acc,2,2,1,1,0.5,0.5
contrib\gis\geos\mutable_list.py,adjusted_acc,12,2,2,10,1.0,0.17
contrib\gis\geos\mutable_list.py,base_acc,12,2,2,10,1.0,0.17
contrib\gis\geos\point.py,adjusted_acc,3,0,0,3,-,0.0
contrib\gis\geos\point.py,base_acc,3,0,0,3,-,0.0
contrib\gis\geos\polygon.py,adjusted_acc,4,2,0,4,0.0,0.0
contrib\gis\geos\polygon.py,base_acc,4,2,1,3,0.5,0.25
contrib\gis\geos\prepared.py,adjusted_acc,18,0,0,18,-,0.0
contrib\gis\geos\prepared.py,base_acc,18,0,0,18,-,0.0
contrib\gis\geos\prototypes\coordseq.py,adjusted_acc,0,0,0,0,-,-
contrib\gis\geos\prototypes\coordseq.py,base_acc,0,0,0,0,-,-
contrib\gis\geos\prototypes\errcheck.py,adjusted_acc,0,0,0,0,-,-
contrib\gis\geos\prototypes\errcheck.py,base_acc,0,0,0,0,-,-
contrib\gis\geos\prototypes\io.py,adjusted_acc,7,0,0,7,-,0.0
contrib\gis\geos\prototypes\io.py,base_acc,7,0,0,7,-,0.0
contrib\gis\geos\prototypes\threadsafe.py,adjusted_acc,0,0,0,0,-,-
contrib\gis\geos\prototypes\threadsafe.py,base_acc,0,0,0,0,-,-
contrib\gis\serializers\geojson.py,adjusted_acc,0,0,0,0,-,-
contrib\gis\serializers\geojson.py,base_acc,0,0,0,0,-,-
contrib\gis\sitemaps\kml.py,adjusted_acc,0,0,0,0,-,-
contrib\gis\sitemaps\kml.py,base_acc,0,0,0,0,-,-
contrib\gis\sitemaps\views.py,adjusted_acc,13,2,2,11,1.0,0.15
contrib\gis\sitemaps\views.py,base_acc,13,2,2,11,1.0,0.15
contrib\gis\utils\layermapping.py,adjusted_acc,16,0,0,16,-,0.0
contrib\gis\utils\layermapping.py,base_acc,16,0,0,16,-,0.0
contrib\gis\utils\ogrinfo.py,adjusted_acc,2,0,0,2,-,0.0
contrib\gis\utils\ogrinfo.py,base_acc,2,0,0,2,-,0.0
contrib\gis\utils\ogrinspect.py,adjusted_acc,6,2,1,5,0.5,0.17
contrib\gis\utils\ogrinspect.py,base_acc,6,2,2,4,1.0,0.33
contrib\gis\utils\srs.py,adjusted_acc,1,0,0,1,-,0.0
contrib\gis\utils\srs.py,base_acc,1,0,0,1,-,0.0
contrib\messages\api.py,adjusted_acc,32,3,1,31,0.33,0.03
contrib\messages\api.py,base_acc,32,3,2,30,0.67,0.06
contrib\messages\context_processors.py,adjusted_acc,2,1,0,2,0.0,0.0
contrib\messages\context_processors.py,base_acc,2,1,1,1,1.0,0.5
contrib\messages\middleware.py,adjusted_acc,4,0,0,4,-,0.0
contrib\messages\middleware.py,base_acc,4,0,0,4,-,0.0
contrib\messages\utils.py,adjusted_acc,1,1,0,1,0.0,0.0
contrib\messages\utils.py,base_acc,1,1,1,0,1.0,1.0
contrib\messages\storage\base.py,adjusted_acc,11,3,0,11,0.0,0.0
contrib\messages\storage\base.py,base_acc,11,3,0,11,0.0,0.0
contrib\messages\storage\cookie.py,adjusted_acc,0,0,0,0,-,-
contrib\messages\storage\cookie.py,base_acc,0,0,0,0,-,-
contrib\messages\storage\session.py,adjusted_acc,5,2,1,4,0.5,0.2
contrib\messages\storage\session.py,base_acc,5,2,1,4,0.5,0.2
contrib\messages\storage\__init__.py,adjusted_acc,2,1,0,2,0.0,0.0
contrib\messages\storage\__init__.py,base_acc,2,1,0,2,0.0,0.0
contrib\postgres\apps.py,adjusted_acc,0,0,0,0,-,-
contrib\postgres\apps.py,base_acc,0,0,0,0,-,-
contrib\postgres\expressions.py,adjusted_acc,2,1,1,1,1.0,0.5
contrib\postgres\expressions.py,base_acc,2,1,1,1,1.0,0.5
contrib\postgres\indexes.py,adjusted_acc,9,2,1,8,0.5,0.11
contrib\postgres\indexes.py,base_acc,9,2,1,8,0.5,0.11
contrib\postgres\operations.py,adjusted_acc,11,1,1,10,1.0,0.09
contrib\postgres\operations.py,base_acc,11,1,1,10,1.0,0.09
contrib\postgres\search.py,adjusted_acc,28,1,0,28,0.0,0.0
contrib\postgres\search.py,base_acc,28,1,0,28,0.0,0.0
contrib\postgres\serializers.py,adjusted_acc,1,1,0,1,0.0,0.0
contrib\postgres\serializers.py,base_acc,1,1,1,0,1.0,1.0
contrib\postgres\signals.py,adjusted_acc,4,2,0,4,0.0,0.0
contrib\postgres\signals.py,base_acc,4,2,2,2,1.0,0.5
contrib\postgres\utils.py,adjusted_acc,1,1,1,0,1.0,1.0
contrib\postgres\utils.py,base_acc,1,1,1,0,1.0,1.0
contrib\postgres\validators.py,adjusted_acc,3,0,0,3,-,0.0
contrib\postgres\validators.py,base_acc,3,0,0,3,-,0.0
contrib\postgres\aggregates\general.py,adjusted_acc,1,1,1,0,1.0,1.0
contrib\postgres\aggregates\general.py,base_acc,1,1,1,0,1.0,1.0
contrib\postgres\fields\array.py,adjusted_acc,4,1,0,4,0.0,0.0
contrib\postgres\fields\array.py,base_acc,4,1,0,4,0.0,0.0
contrib\postgres\fields\ranges.py,adjusted_acc,4,0,0,4,-,0.0
contrib\postgres\fields\ranges.py,base_acc,4,0,0,4,-,0.0
contrib\postgres\fields\utils.py,adjusted_acc,0,0,0,0,-,-
contrib\postgres\fields\utils.py,base_acc,0,0,0,0,-,-
contrib\postgres\forms\array.py,adjusted_acc,27,8,1,26,0.12,0.04
contrib\postgres\forms\array.py,base_acc,27,8,1,26,0.12,0.04
contrib\postgres\forms\hstore.py,adjusted_acc,2,1,0,2,0.0,0.0
contrib\postgres\forms\hstore.py,base_acc,2,1,1,1,1.0,0.5
contrib\postgres\forms\ranges.py,adjusted_acc,6,2,0,6,0.0,0.0
contrib\postgres\forms\ranges.py,base_acc,6,2,0,6,0.0,0.0
contrib\redirects\middleware.py,adjusted_acc,3,1,0,3,0.0,0.0
contrib\redirects\middleware.py,base_acc,3,1,0,3,0.0,0.0
contrib\sessions\base_session.py,adjusted_acc,8,2,0,8,0.0,0.0
contrib\sessions\base_session.py,base_acc,8,2,0,8,0.0,0.0
contrib\sessions\middleware.py,adjusted_acc,4,0,0,4,-,0.0
contrib\sessions\middleware.py,base_acc,4,0,0,4,-,0.0
contrib\sessions\backends\base.py,adjusted_acc,21,10,5,16,0.5,0.24
contrib\sessions\backends\base.py,base_acc,21,10,5,16,0.5,0.24
contrib\sessions\backends\cache.py,adjusted_acc,2,1,0,2,0.0,0.0
contrib\sessions\backends\cache.py,base_acc,2,1,0,2,0.0,0.0
contrib\sessions\backends\cached_db.py,adjusted_acc,2,1,0,2,0.0,0.0
contrib\sessions\backends\cached_db.py,base_acc,2,1,0,2,0.0,0.0
contrib\sessions\backends\db.py,adjusted_acc,5,2,0,5,0.0,0.0
contrib\sessions\backends\db.py,base_acc,5,2,2,3,1.0,0.4
contrib\sessions\backends\file.py,adjusted_acc,1,0,0,1,-,0.0
contrib\sessions\backends\file.py,base_acc,1,0,0,1,-,0.0
contrib\sessions\management\commands\clearsessions.py,adjusted_acc,0,0,0,0,-,-
contrib\sessions\management\commands\clearsessions.py,base_acc,0,0,0,0,-,-
contrib\sitemaps\views.py,adjusted_acc,14,2,1,13,0.5,0.07
contrib\sitemaps\views.py,base_acc,14,2,1,13,0.5,0.07
contrib\sitemaps\__init__.py,adjusted_acc,23,8,1,22,0.12,0.04
contrib\sitemaps\__init__.py,base_acc,23,8,3,20,0.38,0.13
contrib\sites\checks.py,adjusted_acc,2,1,0,2,0.0,0.0
contrib\sites\checks.py,base_acc,2,1,0,2,0.0,0.0
contrib\sites\management.py,adjusted_acc,5,0,0,5,-,0.0
contrib\sites\management.py,base_acc,5,0,0,5,-,0.0
contrib\sites\managers.py,adjusted_acc,1,0,0,1,-,0.0
contrib\sites\managers.py,base_acc,1,0,0,1,-,0.0
contrib\sites\middleware.py,adjusted_acc,1,0,0,1,-,0.0
contrib\sites\middleware.py,base_acc,1,0,0,1,-,0.0
contrib\sites\models.py,adjusted_acc,6,2,0,6,0.0,0.0
contrib\sites\models.py,base_acc,6,2,1,5,0.5,0.17
contrib\sites\requests.py,adjusted_acc,5,0,0,5,-,0.0
contrib\sites\requests.py,base_acc,5,0,0,5,-,0.0
contrib\sites\shortcuts.py,adjusted_acc,2,1,0,2,0.0,0.0
contrib\sites\shortcuts.py,base_acc,2,1,1,1,1.0,0.5
contrib\staticfiles\checks.py,adjusted_acc,2,1,0,2,0.0,0.0
contrib\staticfiles\checks.py,base_acc,2,1,1,1,1.0,0.5
contrib\staticfiles\finders.py,adjusted_acc,37,11,1,36,0.09,0.03
contrib\staticfiles\finders.py,base_acc,37,11,5,32,0.45,0.14
contrib\staticfiles\handlers.py,adjusted_acc,18,4,1,17,0.25,0.06
contrib\staticfiles\handlers.py,base_acc,18,4,1,17,0.25,0.06
contrib\staticfiles\storage.py,adjusted_acc,32,9,4,28,0.44,0.12
contrib\staticfiles\storage.py,base_acc,32,9,5,27,0.56,0.16
contrib\staticfiles\urls.py,adjusted_acc,2,1,0,2,0.0,0.0
contrib\staticfiles\urls.py,base_acc,2,1,0,2,0.0,0.0
contrib\staticfiles\utils.py,adjusted_acc,8,2,1,7,0.5,0.12
contrib\staticfiles\utils.py,base_acc,8,2,1,7,0.5,0.12
contrib\staticfiles\views.py,adjusted_acc,4,1,0,4,0.0,0.0
contrib\staticfiles\views.py,base_acc,4,1,0,4,0.0,0.0
contrib\staticfiles\management\commands\collectstatic.py,adjusted_acc,16,4,3,13,0.75,0.19
contrib\staticfiles\management\commands\collectstatic.py,base_acc,16,4,4,12,1.0,0.25
contrib\syndication\views.py,adjusted_acc,23,8,3,20,0.38,0.13
contrib\syndication\views.py,base_acc,23,8,4,19,0.5,0.17
core\asgi.py,adjusted_acc,1,1,1,0,1.0,1.0
core\asgi.py,base_acc,1,1,1,0,1.0,1.0
core\exceptions.py,adjusted_acc,7,2,0,7,0.0,0.0
core\exceptions.py,base_acc,7,2,1,6,0.5,0.14
core\paginator.py,adjusted_acc,26,8,3,23,0.38,0.12
core\paginator.py,base_acc,26,8,5,21,0.62,0.19
core\signing.py,adjusted_acc,40,11,10,30,0.91,0.25
core\signing.py,base_acc,40,11,10,30,0.91,0.25
core\wsgi.py,adjusted_acc,1,1,1,0,1.0,1.0
core\wsgi.py,base_acc,1,1,1,0,1.0,1.0
core\cache\utils.py,adjusted_acc,3,1,1,2,1.0,0.33
core\cache\utils.py,base_acc,3,1,1,2,1.0,0.33
core\cache\__init__.py,adjusted_acc,2,1,0,2,0.0,0.0
core\cache\__init__.py,base_acc,2,1,0,2,0.0,0.0
core\cache\backends\db.py,adjusted_acc,3,0,0,3,-,0.0
core\cache\backends\db.py,base_acc,3,0,0,3,-,0.0
core\cache\backends\dummy.py,adjusted_acc,1,0,0,1,-,0.0
core\cache\backends\dummy.py,base_acc,1,0,0,1,-,0.0
core\cache\backends\filebased.py,adjusted_acc,2,0,0,2,-,0.0
core\cache\backends\filebased.py,base_acc,2,0,0,2,-,0.0
core\cache\backends\locmem.py,adjusted_acc,2,0,0,2,-,0.0
core\cache\backends\locmem.py,base_acc,2,0,0,2,-,0.0
core\cache\backends\memcached.py,adjusted_acc,10,2,0,10,0.0,0.0
core\cache\backends\memcached.py,base_acc,10,2,1,9,0.5,0.1
core\checks\async_checks.py,adjusted_acc,2,1,0,2,0.0,0.0
core\checks\async_checks.py,base_acc,2,1,0,2,0.0,0.0
core\checks\caches.py,adjusted_acc,6,3,0,6,0.0,0.0
core\checks\caches.py,base_acc,6,3,0,6,0.0,0.0
core\checks\database.py,adjusted_acc,2,1,0,2,0.0,0.0
core\checks\database.py,base_acc,2,1,0,2,0.0,0.0
core\checks\files.py,adjusted_acc,2,1,0,2,0.0,0.0
core\checks\files.py,base_acc,2,1,0,2,0.0,0.0
core\checks\messages.py,adjusted_acc,7,2,2,5,1.0,0.29
core\checks\messages.py,base_acc,7,2,2,5,1.0,0.29
core\checks\model_checks.py,adjusted_acc,4,2,0,4,0.0,0.0
core\checks\model_checks.py,base_acc,4,2,0,4,0.0,0.0
core\checks\registry.py,adjusted_acc,13,5,1,12,0.2,0.08
core\checks\registry.py,base_acc,13,5,5,8,1.0,0.38
core\checks\templates.py,adjusted_acc,6,3,0,6,0.0,0.0
core\checks\templates.py,base_acc,6,3,0,6,0.0,0.0
core\checks\translation.py,adjusted_acc,8,4,0,8,0.0,0.0
core\checks\translation.py,base_acc,8,4,0,8,0.0,0.0
core\checks\urls.py,adjusted_acc,11,6,1,10,0.17,0.09
core\checks\urls.py,base_acc,11,6,1,10,0.17,0.09
core\checks\compatibility\django_4_0.py,adjusted_acc,2,1,0,2,0.0,0.0
core\checks\compatibility\django_4_0.py,base_acc,2,1,1,1,1.0,0.5
core\checks\security\base.py,adjusted_acc,28,14,0,28,0.0,0.0
core\checks\security\base.py,base_acc,28,14,0,28,0.0,0.0
core\checks\security\csrf.py,adjusted_acc,6,3,0,6,0.0,0.0
core\checks\security\csrf.py,base_acc,6,3,0,6,0.0,0.0
core\checks\security\sessions.py,adjusted_acc,8,2,0,8,0.0,0.0
core\checks\security\sessions.py,base_acc,8,2,0,8,0.0,0.0
core\files\base.py,adjusted_acc,23,4,3,20,0.75,0.13
core\files\base.py,base_acc,23,4,3,20,0.75,0.13
core\files\images.py,adjusted_acc,5,3,0,5,0.0,0.0
core\files\images.py,base_acc,5,3,0,5,0.0,0.0
core\files\move.py,adjusted_acc,4,0,0,4,-,0.0
core\files\move.py,base_acc,4,0,0,4,-,0.0
core\files\uploadedfile.py,adjusted_acc,24,1,1,23,1.0,0.04
core\files\uploadedfile.py,base_acc,24,1,1,23,1.0,0.04
core\files\uploadhandler.py,adjusted_acc,37,7,0,37,0.0,0.0
core\files\uploadhandler.py,base_acc,37,7,0,37,0.0,0.0
core\files\utils.py,adjusted_acc,7,4,3,4,0.75,0.43
core\files\utils.py,base_acc,7,4,3,4,0.75,0.43
core\files\storage\base.py,adjusted_acc,34,4,4,30,1.0,0.12
core\files\storage\base.py,base_acc,34,4,4,30,1.0,0.12
core\files\storage\filesystem.py,adjusted_acc,9,0,0,9,-,0.0
core\files\storage\filesystem.py,base_acc,9,0,0,9,-,0.0
core\files\storage\handler.py,adjusted_acc,5,2,0,5,0.0,0.0
core\files\storage\handler.py,base_acc,5,2,0,5,0.0,0.0
core\files\storage\memory.py,adjusted_acc,9,0,0,9,-,0.0
core\files\storage\memory.py,base_acc,9,0,0,9,-,0.0
core\handlers\asgi.py,adjusted_acc,19,6,0,19,0.0,0.0
core\handlers\asgi.py,base_acc,19,6,2,17,0.33,0.11
core\handlers\base.py,adjusted_acc,20,2,1,19,0.5,0.05
core\handlers\base.py,base_acc,20,2,1,19,0.5,0.05
core\handlers\exception.py,adjusted_acc,13,4,2,11,0.5,0.15
core\handlers\exception.py,base_acc,13,4,2,11,0.5,0.15
core\handlers\wsgi.py,adjusted_acc,19,3,0,19,0.0,0.0
core\handlers\wsgi.py,base_acc,19,3,0,19,0.0,0.0
core\mail\message.py,adjusted_acc,56,6,3,53,0.5,0.05
core\mail\message.py,base_acc,56,6,5,51,0.83,0.09
core\mail\utils.py,adjusted_acc,1,1,1,0,1.0,1.0
core\mail\utils.py,base_acc,1,1,1,0,1.0,1.0
core\mail\__init__.py,adjusted_acc,24,2,0,24,0.0,0.0
core\mail\__init__.py,base_acc,24,2,0,24,0.0,0.0
core\mail\backends\base.py,adjusted_acc,6,1,0,6,0.0,0.0
core\mail\backends\base.py,base_acc,6,1,0,6,0.0,0.0
core\mail\backends\console.py,adjusted_acc,1,0,0,1,-,0.0
core\mail\backends\console.py,base_acc,1,0,0,1,-,0.0
core\management\base.py,adjusted_acc,42,6,1,41,0.17,0.02
core\management\base.py,base_acc,42,6,2,40,0.33,0.05
core\management\color.py,adjusted_acc,6,4,3,3,0.75,0.5
core\management\color.py,base_acc,6,4,3,3,0.75,0.5
core\management\sql.py,adjusted_acc,11,0,0,11,-,0.0
core\management\sql.py,base_acc,11,0,0,11,-,0.0
core\management\templates.py,adjusted_acc,20,5,4,16,0.8,0.2
core\management\templates.py,base_acc,20,5,5,15,1.0,0.25
core\management\utils.py,adjusted_acc,18,7,4,14,0.57,0.22
core\management\utils.py,base_acc,18,7,7,11,1.0,0.39
core\management\__init__.py,adjusted_acc,14,5,3,11,0.6,0.21
core\management\__init__.py,base_acc,14,5,3,11,0.6,0.21
core\management\commands\check.py,adjusted_acc,0,0,0,0,-,-
core\management\commands\check.py,base_acc,0,0,0,0,-,-
core\management\commands\compilemessages.py,adjusted_acc,5,1,1,4,1.0,0.2
core\management\commands\compilemessages.py,base_acc,5,1,1,4,1.0,0.2
core\management\commands\createcachetable.py,adjusted_acc,3,0,0,3,-,0.0
core\management\commands\createcachetable.py,base_acc,3,0,0,3,-,0.0
core\management\commands\dbshell.py,adjusted_acc,0,0,0,0,-,-
core\management\commands\dbshell.py,base_acc,0,0,0,0,-,-
core\management\commands\diffsettings.py,adjusted_acc,9,4,1,8,0.25,0.11
core\management\commands\diffsettings.py,base_acc,9,4,3,6,0.75,0.33
core\management\commands\flush.py,adjusted_acc,0,0,0,0,-,-
core\management\commands\flush.py,base_acc,0,0,0,0,-,-
core\management\commands\inspectdb.py,adjusted_acc,14,3,1,13,0.33,0.07
core\management\commands\inspectdb.py,base_acc,14,3,3,11,1.0,0.21
core\management\commands\loaddata.py,adjusted_acc,25,10,3,22,0.3,0.12
core\management\commands\loaddata.py,base_acc,25,10,7,18,0.7,0.28
core\management\commands\makemessages.py,adjusted_acc,30,9,3,27,0.33,0.1
core\management\commands\makemessages.py,base_acc,30,9,5,25,0.56,0.17
core\management\commands\makemigrations.py,adjusted_acc,9,1,1,8,1.0,0.11
core\management\commands\makemigrations.py,base_acc,9,1,1,8,1.0,0.11
core\management\commands\migrate.py,adjusted_acc,7,1,0,7,0.0,0.0
core\management\commands\migrate.py,base_acc,7,1,1,6,1.0,0.14
core\management\commands\runserver.py,adjusted_acc,2,1,0,2,0.0,0.0
core\management\commands\runserver.py,base_acc,2,1,0,2,0.0,0.0
core\management\commands\shell.py,adjusted_acc,0,0,0,0,-,-
core\management\commands\shell.py,base_acc,0,0,0,0,-,-
core\management\commands\showmigrations.py,adjusted_acc,4,0,0,4,-,0.0
core\management\commands\showmigrations.py,base_acc,4,0,0,4,-,0.0
core\management\commands\sqlflush.py,adjusted_acc,1,1,1,0,1.0,1.0
core\management\commands\sqlflush.py,base_acc,1,1,1,0,1.0,1.0
core\management\commands\sqlmigrate.py,adjusted_acc,1,1,0,1,0.0,0.0
core\management\commands\sqlmigrate.py,base_acc,1,1,0,1,0.0,0.0
core\management\commands\squashmigrations.py,adjusted_acc,4,0,0,4,-,0.0
core\management\commands\squashmigrations.py,base_acc,4,0,0,4,-,0.0
core\management\commands\startapp.py,adjusted_acc,0,0,0,0,-,-
core\management\commands\startapp.py,base_acc,0,0,0,0,-,-
core\management\commands\startproject.py,adjusted_acc,0,0,0,0,-,-
core\management\commands\startproject.py,base_acc,0,0,0,0,-,-
core\management\commands\test.py,adjusted_acc,0,0,0,0,-,-
core\management\commands\test.py,base_acc,0,0,0,0,-,-
core\serializers\base.py,adjusted_acc,31,4,1,30,0.25,0.03
core\serializers\base.py,base_acc,31,4,2,29,0.5,0.06
core\serializers\json.py,adjusted_acc,2,1,0,2,0.0,0.0
core\serializers\json.py,base_acc,2,1,0,2,0.0,0.0
core\serializers\jsonl.py,adjusted_acc,2,1,0,2,0.0,0.0
core\serializers\jsonl.py,base_acc,2,1,0,2,0.0,0.0
core\serializers\python.py,adjusted_acc,4,2,0,4,0.0,0.0
core\serializers\python.py,base_acc,4,2,1,3,0.5,0.25
core\serializers\pyyaml.py,adjusted_acc,5,1,0,5,0.0,0.0
core\serializers\pyyaml.py,base_acc,5,1,0,5,0.0,0.0
core\serializers\xml_serializer.py,adjusted_acc,3,1,0,3,0.0,0.0
core\serializers\xml_serializer.py,base_acc,3,1,0,3,0.0,0.0
core\serializers\__init__.py,adjusted_acc,18,3,0,18,0.0,0.0
core\serializers\__init__.py,base_acc,18,3,3,15,1.0,0.17
core\servers\basehttp.py,adjusted_acc,4,2,1,3,0.5,0.25
core\servers\basehttp.py,base_acc,4,2,1,3,0.5,0.25
db\transaction.py,adjusted_acc,34,6,1,33,0.17,0.03
db\transaction.py,base_acc,34,6,2,32,0.33,0.06
db\utils.py,adjusted_acc,21,6,1,20,0.17,0.05
db\utils.py,base_acc,21,6,2,19,0.33,0.1
db\__init__.py,adjusted_acc,0,0,0,0,-,-
db\__init__.py,base_acc,0,0,0,0,-,-
db\backends\ddl_references.py,adjusted_acc,51,6,4,47,0.67,0.08
db\backends\ddl_references.py,base_acc,51,6,4,47,0.67,0.08
db\backends\utils.py,adjusted_acc,31,7,4,27,0.57,0.13
db\backends\utils.py,base_acc,31,7,6,25,0.86,0.19
db\backends\base\base.py,adjusted_acc,36,18,7,29,0.39,0.19
db\backends\base\base.py,base_acc,36,18,10,26,0.56,0.28
db\backends\base\client.py,adjusted_acc,5,0,0,5,-,0.0
db\backends\base\client.py,base_acc,5,0,0,5,-,0.0
db\backends\base\creation.py,adjusted_acc,22,4,1,21,0.25,0.05
db\backends\base\creation.py,base_acc,22,4,3,19,0.75,0.14
db\backends\base\features.py,adjusted_acc,5,2,1,4,0.5,0.2
db\backends\base\features.py,base_acc,5,2,1,4,0.5,0.2
db\backends\base\introspection.py,adjusted_acc,32,7,0,32,0.0,0.0
db\backends\base\introspection.py,base_acc,32,7,4,28,0.57,0.12
db\backends\base\validation.py,adjusted_acc,4,2,2,2,1.0,0.5
db\backends\base\validation.py,base_acc,4,2,2,2,1.0,0.5
db\backends\dummy\base.py,adjusted_acc,0,0,0,0,-,-
db\backends\dummy\base.py,base_acc,0,0,0,0,-,-
db\backends\mysql\base.py,adjusted_acc,11,10,7,4,0.7,0.64
db\backends\mysql\base.py,base_acc,11,10,7,4,0.7,0.64
db\backends\mysql\client.py,adjusted_acc,3,1,0,3,0.0,0.0
db\backends\mysql\client.py,base_acc,3,1,1,2,1.0,0.33
db\backends\mysql\compiler.py,adjusted_acc,2,1,0,2,0.0,0.0
db\backends\mysql\compiler.py,base_acc,2,1,0,2,0.0,0.0
db\backends\mysql\creation.py,adjusted_acc,1,1,0,1,0.0,0.0
db\backends\mysql\creation.py,base_acc,1,1,0,1,0.0,0.0
db\backends\mysql\features.py,adjusted_acc,19,13,8,11,0.62,0.42
db\backends\mysql\features.py,base_acc,19,13,8,11,0.62,0.42
db\backends\mysql\operations.py,adjusted_acc,24,2,1,23,0.5,0.04
db\backends\mysql\operations.py,base_acc,24,2,1,23,0.5,0.04
db\backends\mysql\schema.py,adjusted_acc,4,3,3,1,1.0,0.75
db\backends\mysql\schema.py,base_acc,4,3,3,1,1.0,0.75
db\backends\mysql\validation.py,adjusted_acc,0,0,0,0,-,-
db\backends\mysql\validation.py,base_acc,0,0,0,0,-,-
db\backends\oracle\base.py,adjusted_acc,2,1,0,2,0.0,0.0
db\backends\oracle\base.py,base_acc,2,1,1,1,1.0,0.5
db\backends\oracle\client.py,adjusted_acc,5,2,1,4,0.5,0.2
db\backends\oracle\client.py,base_acc,5,2,1,4,0.5,0.2
db\backends\oracle\creation.py,adjusted_acc,0,0,0,0,-,-
db\backends\oracle\creation.py,base_acc,0,0,0,0,-,-
db\backends\oracle\functions.py,adjusted_acc,0,0,0,0,-,-
db\backends\oracle\functions.py,base_acc,0,0,0,0,-,-
db\backends\oracle\schema.py,adjusted_acc,3,1,1,2,1.0,0.33
db\backends\oracle\schema.py,base_acc,3,1,1,2,1.0,0.33
db\backends\oracle\utils.py,adjusted_acc,0,0,0,0,-,-
db\backends\oracle\utils.py,base_acc,0,0,0,0,-,-
db\backends\oracle\validation.py,adjusted_acc,0,0,0,0,-,-
db\backends\oracle\validation.py,base_acc,0,0,0,0,-,-
db\backends\postgresql\base.py,adjusted_acc,5,0,0,5,-,0.0
db\backends\postgresql\base.py,base_acc,5,0,0,5,-,0.0
db\backends\postgresql\client.py,adjusted_acc,4,1,0,4,0.0,0.0
db\backends\postgresql\client.py,base_acc,4,1,1,3,1.0,0.25
db\backends\postgresql\operations.py,adjusted_acc,2,1,1,1,1.0,0.5
db\backends\postgresql\operations.py,base_acc,2,1,1,1,1.0,0.5
db\backends\postgresql\schema.py,adjusted_acc,3,0,0,3,-,0.0
db\backends\postgresql\schema.py,base_acc,3,0,0,3,-,0.0
db\backends\sqlite3\base.py,adjusted_acc,3,1,0,3,0.0,0.0
db\backends\sqlite3\base.py,base_acc,3,1,1,2,1.0,0.33
db\backends\sqlite3\client.py,adjusted_acc,3,1,0,3,0.0,0.0
db\backends\sqlite3\client.py,base_acc,3,1,1,2,1.0,0.33
db\backends\sqlite3\creation.py,adjusted_acc,2,1,1,1,1.0,0.5
db\backends\sqlite3\creation.py,base_acc,2,1,1,1,1.0,0.5
db\backends\sqlite3\introspection.py,adjusted_acc,3,1,1,2,1.0,0.33
db\backends\sqlite3\introspection.py,base_acc,3,1,1,2,1.0,0.33
db\backends\sqlite3\operations.py,adjusted_acc,4,2,1,3,0.5,0.25
db\backends\sqlite3\operations.py,base_acc,4,2,2,2,1.0,0.5
db\migrations\autodetector.py,adjusted_acc,25,3,1,24,0.33,0.04
db\migrations\autodetector.py,base_acc,25,3,3,22,1.0,0.12
db\migrations\exceptions.py,adjusted_acc,3,0,0,3,-,0.0
db\migrations\exceptions.py,base_acc,3,0,0,3,-,0.0
db\migrations\executor.py,adjusted_acc,24,4,1,23,0.25,0.04
db\migrations\executor.py,base_acc,24,4,2,22,0.5,0.08
db\migrations\graph.py,adjusted_acc,37,6,1,36,0.17,0.03
db\migrations\graph.py,base_acc,37,6,6,31,1.0,0.16
db\migrations\loader.py,adjusted_acc,24,4,1,23,0.25,0.04
db\migrations\loader.py,base_acc,24,4,2,22,0.5,0.08
db\migrations\migration.py,adjusted_acc,17,1,1,16,1.0,0.06
db\migrations\migration.py,base_acc,17,1,1,16,1.0,0.06
db\migrations\optimizer.py,adjusted_acc,6,2,0,6,0.0,0.0
db\migrations\optimizer.py,base_acc,6,2,2,4,1.0,0.33
db\migrations\questioner.py,adjusted_acc,19,4,0,19,0.0,0.0
db\migrations\questioner.py,base_acc,19,4,0,19,0.0,0.0
db\migrations\recorder.py,adjusted_acc,8,2,1,7,0.5,0.12
db\migrations\recorder.py,base_acc,8,2,1,7,0.5,0.12
db\migrations\serializer.py,adjusted_acc,9,2,0,9,0.0,0.0
db\migrations\serializer.py,base_acc,9,2,1,8,0.5,0.11
db\migrations\utils.py,adjusted_acc,1,1,1,0,1.0,1.0
db\migrations\utils.py,base_acc,1,1,1,0,1.0,1.0
db\migrations\writer.py,adjusted_acc,15,6,2,13,0.33,0.13
db\migrations\writer.py,base_acc,15,6,3,12,0.5,0.2
db\migrations\operations\base.py,adjusted_acc,26,7,2,24,0.29,0.08
db\migrations\operations\base.py,base_acc,26,7,4,22,0.57,0.15
db\migrations\operations\fields.py,adjusted_acc,22,0,0,22,-,0.0
db\migrations\operations\fields.py,base_acc,22,0,0,22,-,0.0
db\migrations\operations\special.py,adjusted_acc,16,2,2,14,1.0,0.12
db\migrations\operations\special.py,base_acc,16,2,2,14,1.0,0.12
db\models\constraints.py,adjusted_acc,11,1,1,10,1.0,0.09
db\models\constraints.py,base_acc,11,1,1,10,1.0,0.09
db\models\enums.py,adjusted_acc,2,1,0,2,0.0,0.0
db\models\enums.py,base_acc,2,1,0,2,0.0,0.0
db\models\indexes.py,adjusted_acc,19,5,1,18,0.2,0.05
db\models\indexes.py,base_acc,19,5,2,17,0.4,0.11
db\models\manager.py,adjusted_acc,19,5,2,17,0.4,0.11
db\models\manager.py,base_acc,19,5,2,17,0.4,0.11
db\models\options.py,adjusted_acc,43,21,6,37,0.29,0.14
db\models\options.py,base_acc,43,21,16,27,0.76,0.37
db\models\query_utils.py,adjusted_acc,35,8,4,31,0.5,0.11
db\models\query_utils.py,base_acc,35,8,6,29,0.75,0.17
db\models\signals.py,adjusted_acc,10,1,0,10,0.0,0.0
db\models\signals.py,base_acc,10,1,0,10,0.0,0.0
db\models\utils.py,adjusted_acc,8,4,0,8,0.0,0.0
db\models\utils.py,base_acc,8,4,1,7,0.25,0.12
db\models\fields\files.py,adjusted_acc,30,3,0,30,0.0,0.0
db\models\fields\files.py,base_acc,30,3,0,30,0.0,0.0
db\models\fields\json.py,adjusted_acc,12,2,2,10,1.0,0.17
db\models\fields\json.py,base_acc,12,2,2,10,1.0,0.17
db\models\fields\mixins.py,adjusted_acc,8,2,1,7,0.5,0.12
db\models\fields\mixins.py,base_acc,8,2,1,7,0.5,0.12
db\models\fields\related_descriptors.py,adjusted_acc,41,8,1,40,0.12,0.02
db\models\fields\related_descriptors.py,base_acc,41,8,8,33,1.0,0.2
db\models\fields\related_lookups.py,adjusted_acc,10,3,0,10,0.0,0.0
db\models\fields\related_lookups.py,base_acc,10,3,0,10,0.0,0.0
db\models\fields\reverse_related.py,adjusted_acc,60,5,0,60,0.0,0.0
db\models\fields\reverse_related.py,base_acc,60,5,0,60,0.0,0.0
db\models\functions\comparison.py,adjusted_acc,2,0,0,2,-,0.0
db\models\functions\comparison.py,base_acc,2,0,0,2,-,0.0
db\models\functions\datetime.py,adjusted_acc,2,1,0,2,0.0,0.0
db\models\functions\datetime.py,base_acc,2,1,0,2,0.0,0.0
db\models\functions\text.py,adjusted_acc,70,17,2,68,0.12,0.03
db\models\functions\text.py,base_acc,70,17,2,68,0.12,0.03
db\models\functions\window.py,adjusted_acc,6,0,0,6,-,0.0
db\models\functions\window.py,base_acc,6,0,0,6,-,0.0
db\models\sql\compiler.py,adjusted_acc,81,29,6,75,0.21,0.07
db\models\sql\compiler.py,base_acc,81,29,15,66,0.52,0.19
db\models\sql\datastructures.py,adjusted_acc,23,6,0,23,0.0,0.0
db\models\sql\datastructures.py,base_acc,23,6,0,23,0.0,0.0
db\models\sql\subqueries.py,adjusted_acc,19,3,0,19,0.0,0.0
db\models\sql\subqueries.py,base_acc,19,3,1,18,0.33,0.05
db\models\sql\where.py,adjusted_acc,28,10,4,24,0.4,0.14
db\models\sql\where.py,base_acc,28,10,5,23,0.5,0.18
dispatch\dispatcher.py,adjusted_acc,15,5,2,13,0.4,0.13
dispatch\dispatcher.py,base_acc,15,5,5,10,1.0,0.33
forms\boundfield.py,adjusted_acc,43,5,2,41,0.4,0.05
forms\boundfield.py,base_acc,43,5,2,41,0.4,0.05
forms\forms.py,adjusted_acc,35,13,6,29,0.46,0.17
forms\forms.py,base_acc,35,13,10,25,0.77,0.29
forms\formsets.py,adjusted_acc,51,19,9,42,0.47,0.18
forms\formsets.py,base_acc,51,19,16,35,0.84,0.31
forms\renderers.py,adjusted_acc,11,3,0,11,0.0,0.0
forms\renderers.py,base_acc,11,3,1,10,0.33,0.09
forms\utils.py,adjusted_acc,30,13,2,28,0.15,0.07
forms\utils.py,base_acc,30,13,5,25,0.38,0.17
http\cookie.py,adjusted_acc,2,1,0,2,0.0,0.0
http\cookie.py,base_acc,2,1,1,1,1.0,0.5
http\multipartparser.py,adjusted_acc,23,4,2,21,0.5,0.09
http\multipartparser.py,base_acc,23,4,2,21,0.5,0.09
http\request.py,adjusted_acc,74,26,14,60,0.54,0.19
http\request.py,base_acc,74,26,18,56,0.69,0.24
http\response.py,adjusted_acc,67,11,6,61,0.55,0.09
http\response.py,base_acc,67,11,6,61,0.55,0.09
middleware\cache.py,adjusted_acc,8,1,0,8,0.0,0.0
middleware\cache.py,base_acc,8,1,0,8,0.0,0.0
middleware\clickjacking.py,adjusted_acc,6,1,0,6,0.0,0.0
middleware\clickjacking.py,base_acc,6,1,0,6,0.0,0.0
middleware\common.py,adjusted_acc,20,5,3,17,0.6,0.15
middleware\common.py,base_acc,20,5,3,17,0.6,0.15
middleware\csrf.py,adjusted_acc,18,5,1,17,0.2,0.06
middleware\csrf.py,base_acc,18,5,4,14,0.8,0.22
middleware\http.py,adjusted_acc,5,2,1,4,0.5,0.2
middleware\http.py,base_acc,5,2,1,4,0.5,0.2
middleware\locale.py,adjusted_acc,4,0,0,4,-,0.0
middleware\locale.py,base_acc,4,0,0,4,-,0.0
middleware\security.py,adjusted_acc,5,1,1,4,1.0,0.2
middleware\security.py,base_acc,5,1,1,4,1.0,0.2
template\base.py,adjusted_acc,83,20,7,76,0.35,0.08
template\base.py,base_acc,83,20,13,70,0.65,0.16
template\context.py,adjusted_acc,38,11,2,36,0.18,0.05
template\context.py,base_acc,38,11,3,35,0.27,0.08
template\context_processors.py,adjusted_acc,14,7,1,13,0.14,0.07
template\context_processors.py,base_acc,14,7,7,7,1.0,0.5
template\engine.py,adjusted_acc,33,12,5,28,0.42,0.15
template\engine.py,base_acc,33,12,10,23,0.83,0.3
template\exceptions.py,adjusted_acc,4,0,0,4,-,0.0
template\exceptions.py,base_acc,4,0,0,4,-,0.0
template\library.py,adjusted_acc,43,7,0,43,0.0,0.0
template\library.py,base_acc,43,7,5,38,0.71,0.12
template\loader.py,adjusted_acc,10,2,0,10,0.0,0.0
template\loader.py,base_acc,10,2,0,10,0.0,0.0
template\loader_tags.py,adjusted_acc,37,8,5,32,0.62,0.14
template\loader_tags.py,base_acc,37,8,5,32,0.62,0.14
template\response.py,adjusted_acc,23,4,1,22,0.25,0.04
template\response.py,base_acc,23,4,1,22,0.25,0.04
template\smartif.py,adjusted_acc,15,7,2,13,0.29,0.13
template\smartif.py,base_acc,15,7,4,11,0.57,0.27
template\utils.py,adjusted_acc,6,3,0,6,0.0,0.0
template\utils.py,base_acc,6,3,3,3,1.0,0.5
template\backends\base.py,adjusted_acc,9,2,0,9,0.0,0.0
template\backends\base.py,base_acc,9,2,1,8,0.5,0.11
template\backends\django.py,adjusted_acc,14,3,2,12,0.67,0.14
template\backends\django.py,base_acc,14,3,2,12,0.67,0.14
template\backends\dummy.py,adjusted_acc,4,1,1,3,1.0,0.25
template\backends\dummy.py,base_acc,4,1,1,3,1.0,0.25
template\backends\jinja2.py,adjusted_acc,7,2,1,6,0.5,0.14
template\backends\jinja2.py,base_acc,7,2,2,5,1.0,0.29
template\backends\utils.py,adjusted_acc,2,1,0,2,0.0,0.0
template\backends\utils.py,base_acc,2,1,0,2,0.0,0.0
template\loaders\base.py,adjusted_acc,6,1,1,5,1.0,0.17
template\loaders\base.py,base_acc,6,1,1,5,1.0,0.17
template\loaders\cached.py,adjusted_acc,9,2,2,7,1.0,0.22
template\loaders\cached.py,base_acc,9,2,2,7,1.0,0.22
template\loaders\filesystem.py,adjusted_acc,7,2,1,6,0.5,0.14
template\loaders\filesystem.py,base_acc,7,2,1,6,0.5,0.14
template\loaders\locmem.py,adjusted_acc,4,0,0,4,-,0.0
template\loaders\locmem.py,base_acc,4,0,0,4,-,0.0
templatetags\cache.py,adjusted_acc,8,1,1,7,1.0,0.12
templatetags\cache.py,base_acc,8,1,1,7,1.0,0.12
templatetags\i18n.py,adjusted_acc,73,17,8,65,0.47,0.11
templatetags\i18n.py,base_acc,73,17,9,64,0.53,0.12
templatetags\l10n.py,adjusted_acc,7,3,3,4,1.0,0.43
templatetags\l10n.py,base_acc,7,3,3,4,1.0,0.43
templatetags\static.py,adjusted_acc,28,9,3,25,0.33,0.11
templatetags\static.py,base_acc,28,9,3,25,0.33,0.11
templatetags\tz.py,adjusted_acc,18,3,3,15,1.0,0.17
templatetags\tz.py,base_acc,18,3,3,15,1.0,0.17
test\html.py,adjusted_acc,17,6,1,16,0.17,0.06
test\html.py,base_acc,17,6,2,15,0.33,0.12
test\signals.py,adjusted_acc,0,0,0,0,-,-
test\signals.py,base_acc,0,0,0,0,-,-
test\utils.py,adjusted_acc,58,18,0,58,0.0,0.0
test\utils.py,base_acc,58,18,6,52,0.33,0.1
urls\base.py,adjusted_acc,20,6,4,16,0.67,0.2
urls\base.py,base_acc,20,6,4,16,0.67,0.2
urls\conf.py,adjusted_acc,3,1,0,3,0.0,0.0
urls\conf.py,base_acc,3,1,1,2,1.0,0.33
urls\converters.py,adjusted_acc,16,4,3,13,0.75,0.19
urls\converters.py,base_acc,16,4,4,12,1.0,0.25
urls\utils.py,adjusted_acc,4,2,0,4,0.0,0.0
urls\utils.py,base_acc,4,2,0,4,0.0,0.0
utils\archive.py,adjusted_acc,18,2,1,17,0.5,0.06
utils\archive.py,base_acc,18,2,1,17,0.5,0.06
utils\asyncio.py,adjusted_acc,2,1,0,2,0.0,0.0
utils\asyncio.py,base_acc,2,1,0,2,0.0,0.0
utils\autoreload.py,adjusted_acc,38,16,4,34,0.25,0.11
utils\autoreload.py,base_acc,38,16,6,32,0.38,0.16
utils\cache.py,adjusted_acc,29,5,2,27,0.4,0.07
utils\cache.py,base_acc,29,5,2,27,0.4,0.07
utils\connection.py,adjusted_acc,18,3,0,18,0.0,0.0
utils\connection.py,base_acc,18,3,0,18,0.0,0.0
utils\crypto.py,adjusted_acc,16,3,3,13,1.0,0.19
utils\crypto.py,base_acc,16,3,3,13,1.0,0.19
utils\datastructures.py,adjusted_acc,39,10,2,37,0.2,0.05
utils\datastructures.py,base_acc,39,10,4,35,0.4,0.1
utils\dateformat.py,adjusted_acc,48,25,7,41,0.28,0.15
utils\dateformat.py,base_acc,48,25,8,40,0.32,0.17
utils\dateparse.py,adjusted_acc,8,4,3,5,0.75,0.38
utils\dateparse.py,base_acc,8,4,3,5,0.75,0.38
utils\deconstruct.py,adjusted_acc,1,1,0,1,0.0,0.0
utils\deconstruct.py,base_acc,1,1,1,0,1.0,1.0
utils\decorators.py,adjusted_acc,15,4,0,15,0.0,0.0
utils\decorators.py,base_acc,15,4,1,14,0.25,0.07
utils\deprecation.py,adjusted_acc,8,0,0,8,-,0.0
utils\deprecation.py,base_acc,8,0,0,8,-,0.0
utils\duration.py,adjusted_acc,6,2,2,4,1.0,0.33
utils\duration.py,base_acc,6,2,2,4,1.0,0.33
utils\encoding.py,adjusted_acc,29,10,7,22,0.7,0.24
utils\encoding.py,base_acc,29,10,7,22,0.7,0.24
utils\feedgenerator.py,adjusted_acc,52,8,6,46,0.75,0.12
utils\feedgenerator.py,base_acc,52,8,7,45,0.88,0.13
utils\formats.py,adjusted_acc,31,7,1,30,0.14,0.03
utils\formats.py,base_acc,31,7,1,30,0.14,0.03
utils\functional.py,adjusted_acc,21,7,0,21,0.0,0.0
utils\functional.py,base_acc,21,7,3,18,0.43,0.14
utils\hashable.py,adjusted_acc,0,0,0,0,-,-
utils\hashable.py,base_acc,0,0,0,0,-,-
utils\html.py,adjusted_acc,41,13,6,35,0.46,0.15
utils\html.py,base_acc,41,13,7,34,0.54,0.17
utils\http.py,adjusted_acc,35,14,11,24,0.79,0.31
utils\http.py,base_acc,35,14,12,23,0.86,0.34
utils\inspect.py,adjusted_acc,13,6,5,8,0.83,0.38
utils\inspect.py,base_acc,13,6,6,7,1.0,0.46
utils\ipv6.py,adjusted_acc,5,2,2,3,1.0,0.4
utils\ipv6.py,base_acc,5,2,2,3,1.0,0.4
utils\itercompat.py,adjusted_acc,1,1,1,0,1.0,1.0
utils\itercompat.py,base_acc,1,1,1,0,1.0,1.0
utils\jslex.py,adjusted_acc,13,3,0,13,0.0,0.0
utils\jslex.py,base_acc,13,3,0,13,0.0,0.0
utils\log.py,adjusted_acc,18,4,2,16,0.5,0.11
utils\log.py,base_acc,18,4,2,16,0.5,0.11
utils\lorem_ipsum.py,adjusted_acc,8,4,2,6,0.5,0.25
utils\lorem_ipsum.py,base_acc,8,4,3,5,0.75,0.38
utils\module_loading.py,adjusted_acc,6,2,1,5,0.5,0.17
utils\module_loading.py,base_acc,6,2,1,5,0.5,0.17
utils\regex_helper.py,adjusted_acc,17,5,1,16,0.2,0.06
utils\regex_helper.py,base_acc,17,5,1,16,0.2,0.06
utils\safestring.py,adjusted_acc,2,1,0,2,0.0,0.0
utils\safestring.py,base_acc,2,1,0,2,0.0,0.0
utils\termcolors.py,adjusted_acc,7,3,0,7,0.0,0.0
utils\termcolors.py,base_acc,7,3,1,6,0.33,0.14
utils\timesince.py,adjusted_acc,11,2,0,11,0.0,0.0
utils\timesince.py,base_acc,11,2,0,11,0.0,0.0
utils\timezone.py,adjusted_acc,27,8,6,21,0.75,0.22
utils\timezone.py,base_acc,27,8,6,21,0.75,0.22
utils\tree.py,adjusted_acc,10,1,1,9,1.0,0.1
utils\tree.py,base_acc,10,1,1,9,1.0,0.1
utils\version.py,adjusted_acc,11,5,3,8,0.6,0.27
utils\version.py,base_acc,11,5,4,7,0.8,0.36
utils\xmlutils.py,adjusted_acc,6,0,0,6,-,0.0
utils\xmlutils.py,base_acc,6,0,0,6,-,0.0
utils\_os.py,adjusted_acc,5,2,2,3,1.0,0.4
utils\_os.py,base_acc,5,2,2,3,1.0,0.4
utils\translation\reloader.py,adjusted_acc,4,1,0,4,0.0,0.0
utils\translation\reloader.py,base_acc,4,1,0,4,0.0,0.0
utils\translation\template.py,adjusted_acc,6,1,0,6,0.0,0.0
utils\translation\template.py,base_acc,6,1,0,6,0.0,0.0
utils\translation\trans_null.py,adjusted_acc,26,4,1,25,0.25,0.04
utils\translation\trans_null.py,base_acc,26,4,1,25,0.25,0.04
utils\translation\__init__.py,adjusted_acc,52,15,1,51,0.07,0.02
utils\translation\__init__.py,base_acc,52,15,1,51,0.07,0.02
views\csrf.py,adjusted_acc,4,1,1,3,1.0,0.25
views\csrf.py,base_acc,4,1,1,3,1.0,0.25
views\defaults.py,adjusted_acc,15,4,4,11,1.0,0.27
views\defaults.py,base_acc,15,4,4,11,1.0,0.27
views\i18n.py,adjusted_acc,12,8,4,8,0.5,0.33
views\i18n.py,base_acc,12,8,6,6,0.75,0.5
views\static.py,adjusted_acc,9,3,2,7,0.67,0.22
views\static.py,base_acc,9,3,2,7,0.67,0.22
views\decorators\cache.py,adjusted_acc,5,3,0,5,0.0,0.0
views\decorators\cache.py,base_acc,5,3,2,3,0.67,0.4
views\decorators\clickjacking.py,adjusted_acc,6,3,0,6,0.0,0.0
views\decorators\clickjacking.py,base_acc,6,3,0,6,0.0,0.0
views\decorators\common.py,adjusted_acc,2,1,0,2,0.0,0.0
views\decorators\common.py,base_acc,2,1,0,2,0.0,0.0
views\decorators\csrf.py,adjusted_acc,2,1,0,2,0.0,0.0
views\decorators\csrf.py,base_acc,2,1,0,2,0.0,0.0
views\decorators\debug.py,adjusted_acc,2,2,0,2,0.0,0.0
views\decorators\debug.py,base_acc,2,2,2,0,1.0,1.0
views\decorators\http.py,adjusted_acc,9,4,0,9,0.0,0.0
views\decorators\http.py,base_acc,9,4,4,5,1.0,0.44
views\decorators\vary.py,adjusted_acc,1,1,0,1,0.0,0.0
views\decorators\vary.py,base_acc,1,1,1,0,1.0,1.0
views\generic\base.py,adjusted_acc,29,14,2,27,0.14,0.07
views\generic\base.py,base_acc,29,14,4,25,0.29,0.14
views\generic\detail.py,adjusted_acc,8,2,1,7,0.5,0.12
views\generic\detail.py,base_acc,8,2,1,7,0.5,0.12
views\generic\edit.py,adjusted_acc,35,12,4,31,0.33,0.11
views\generic\edit.py,base_acc,35,12,5,30,0.42,0.14
